****************************************************
*.............*....***......***..............*.**..*					           
*....****.....***.......*****....****.....*....**.**
*..*.***...****......**.***...****....********.....*
*.**.****.......*****.......***....*****...*.*.*.***						   
*..****.......*****.....*****....*****...*.*.*.***.*						   				   
*....******...***.......*****....****.....*....**..*
***....*****.............*****.........*....**....**
****************************************************
